22 13 12 11 11 12 13 27 28 29 23 22 13 12 11 11 12 13 27 28
13 13 12 11 11 12 13 13 13 13 12 13 13 12 11 11 12 13 13 13
12 12 12 11 11 12 12 12 12 12 12 12 12 12 11 11 12 12 12 12
11 11 11 11 11 11 11 11 11 11 11 11 11 11 11 11 11 11 11 11
11 11 11 11 11 11 11 11 11 11 11 11 11 11 11 11 11 11 11 11
12 12 12 11 11 12 12 12 12 12 12 12 12 12 11 11 12 12 12 12
13 13 12 11 11 12 13 13 13 13 13 13 13 12 11 11 12 13 13 13
18 13 12 11 11 12 13 30 34 34 34 32 13 12 11 11 12 13 16 20
19 13 12 11 11 12 13 31 35 35 35 33 13 12 11 11 12 13 17 21
22 13 12 11 11 12 13 38 39 40 36 36 13 12 11 11 12 13 24 25 
22 13 12 11 11 12 13 41 42 43 37 36 13 12 11 11 12 13 27 28
13 13 12 11 11 12 13 13 13 13 12 13 13 12 11 11 12 13 13 13 
12 12 12 11 11 12 12 12 12 12 12 12 12 12 11 11 12 12 12 12
11 11 11 11 11 11 11 11 11 11 11 11 11 11 11 11 11 11 11 11
11 11 11 11 11 11 11 11 11 11 11 11 11 11 11 11 11 11 11 11
12 12 12 11 11 12 12 12 12 12 12 12 12 12 11 11 12 12 12 12
13 13 12 11 11 12 13 13 13 13 13 13 13 12 11 11 12 13 13 13
18 13 12 11 11 12 13 16 20 20 20 18 13 12 11 11 12 13 16 20
19 13 12 11 11 12 13 17 21 21 21 19 13 12 11 11 12 13 17 21 
22 13 12 11 11 12 13 24 25 26 22 22 13 12 11 11 12 13 24 25

