22 00 00 00 00 00 00 27 28 29 23 22 00 00 00 00 00 00 27 28
00 00 00 00 00 00 00 00 00 00 00 00 00 00 00 00 00 00 00 00
00 00 00 00 00 00 00 00 00 00 00 00 00 00 00 00 00 00 00 00
00 00 00 00 00 00 00 00 00 00 00 00 00 00 00 00 00 00 00 00
00 00 00 00 00 00 00 00 00 00 00 00 00 00 00 00 00 00 00 00
00 00 00 00 00 00 00 00 00 00 00 00 00 00 00 00 00 00 00 00
00 00 00 00 00 00 00 00 00 00 00 00 00 00 00 00 00 00 00 00
18 00 00 00 00 00 00 30 34 34 34 32 00 00 00 00 00 00 16 20
19 00 00 00 00 00 00 31 35 35 35 33 00 00 00 00 00 00 17 21
22 00 00 00 00 00 00 38 39 40 36 36 00 00 00 00 00 00 24 25 
22 00 00 00 00 00 00 41 42 43 00 36 00 00 00 00 00 00 27 28
00 00 00 00 00 00 00 00 00 00 00 00 00 00 00 00 00 00 00 00 
00 00 00 00 00 00 00 00 00 00 00 00 00 00 00 00 00 00 00 00
00 00 00 00 00 00 00 00 00 00 00 00 00 00 00 00 00 00 00 00
00 00 00 00 00 00 00 00 00 00 00 00 00 00 00 00 00 00 00 00
00 00 00 00 00 00 00 00 00 00 00 00 00 00 00 00 00 00 00 00
00 00 00 00 00 00 00 00 00 00 00 00 00 00 00 00 00 00 00 00
18 00 00 00 00 00 00 16 20 20 20 18 00 00 00 00 00 00 16 20
19 00 00 00 00 00 00 17 21 21 21 19 00 00 00 00 00 00 17 21 
22 00 00 00 00 00 00 24 25 26 22 22 00 00 00 00 00 00 24 25

